S---O----O------
-OOO-----O------
---O---OOOO-----
---O------------
EOOOOOOOOOOOOO--
----------------
