--------------
-O-O-O-O-O-O-O
-O---O-OOO-O-O
-O-OOOOOOO-O-O
-O-O---O---O-O
-O-OOO-OOOOO-O
-O---S-O---E-O
-OOOOOOO-O-O-O
-O-------O-O-O
-OOOOOOOOO-O-O
--------------
