-----------
---O-O-O---
---O---O---
---O-O-O---
---S---E---
---O-O-O---
---O---O---
-----------
