S----O----O----
OOOOO--O----O--
---O---O----O--
---O-O----O----
---O-OOOOOOOOOE
---------------
