-----------
-S---O-O-O-
-OOO-O-O-O-
-O---O-O-O-
-OOOOOOOOO-
-O-O---O---
-OOOOOOOOOO
OO---O---E-
-----------
