SOOOO-------
---O---O----
---O---O----
---OOOOOOO--
---------OOE
------------
