----------
-SOOOO----
--O--O----
--O--O----
--O--OOOO-
--OOO--OOE
----------
