---------
-O---O---
-OOOOOOO-
-S---O---
-OOOOOOE-
-------O-
---------
