SOOO---------
--O-O--------
--O--O-------
--O----------
--O----O--O--
--OOOOOOOOE--
-------------
